todo:5.4


http://c.biancheng.net/unity3d/


替换记录：

小狗 -> 小猫
课题 -> 设计
玩家 -> 用户
相关 -> 一系列
环境 -> 路段
金币 -> 鱼骨头
结束 -> 完成
钻石 -> 金砖 -> 金砖道具
“成绩” -> “RANKING”
成绩界面 -> 排行榜界面
“返回” -> “关闭”
主菜单界面 -> 主界面
“设置” -> “SETTING”
设置界面 -> 设置选项界面
滑动 -> 滑动或者点击
“关于” -> 设置界面中的“ABOUT”
进入 -> 进入到
“开始游戏” -> “Run”
游戏界面 -> 游戏中主界面
计分板 -> 鱼骨头数量计数板
道具效果 -> 道具
显示条 -> 进度条
按下 -> 点击
游戏暂停界面 -> 暂停界面
滚出 -> 弹出
游戏结束 -> 游戏完成
“主菜单” -> “MAIN MENU”
游戏中的 -> 游戏场景中的
操控 -> 操作
障碍物 -> 障碍物
研发 -> 开发
游戏场景 -> Scene
主摄像机 -> Main Camera
森林 -> 城市
或者 -> 或
设置选项界面 -> 用户设置界面
障碍 -> 栅栏障碍物
磁铁 -> 磁铁道具
游戏的设计 -> 游戏系统的设计












